{
    "9120": 119999999,
    "99": 119999999,
    "13": 119999999,
    "40": 119999999,
    "60": 119999999,
    "30": 119999999,
    "1200": 110106000,
    "70": 119999999,
    "50": 119999999,
    "1110": 110101000,
    "11": 119999999,
    "4380": 110600001,
    "4100": 110600002,
    "42": 119999999,
    "20": 119999999,
    "4351": 110600003,
    "1120": 110101000,
    "1500": 110102000,
    "1100": 110101000,
    "41": 119999999,
    "9520": 119999999,
    "1520": 110102000,
    "12": 119999999,
    "6224": 119999999,
    "4420": 119999999,
    "3300": 119999999,
    "5100": 119999999,
    "1700": 119999999,
    "7920": 119999999,
    "1510": 110102000,
    "9110": 119999999,
    "98": 119999999,
    "3610": 119999999,
    "9100": 119999999,
    "1910": 119999999,
    "9211": 119999999,
    "3900": 119999999,
    "9920": 119999999,
    "3510": 119999999,
    "1900": 119999999,
    "3210": 119999999,
    "8100": 119999999,
    "3550": 119999999,
    "4352": 110600003,
    "1920": 119999999,
    "9500": 119999999,
    "1300": 119999999,
    "1400": 110107000,
    "7100": 119999999,
    "1600": 110103000,
    "1610": 110103000,
    "4350": 110600003,
    "4330": 119999999,
    "3230": 119999999,
    "3000": 119999999,
    "7700": 119999999,
    "3690": 119999999,
    "1800": 110107000,
    "3450": 119999999,
    "3540": 119999999,
    "2260": 119999999,
    "2900": 119999999,
    "4200": 119999999,
    "1000": 119999999,
    "3240": 119999999,
    "1620": 110103000,
    "3490": 119999999,
    "3530": 119999999,
    "2390": 119999999,
    "2140": 119999999,
    "2230": 119999999,
    "2310": 119999999,
    "4370": 119999999,
    "2340": 119999999,
    "2130": 119999999,
    "3190": 119999999,
    "3460": 119999999,
    "2190": 119999999,
    "9910": 119999999,
    "9213": 119999999,
    "3640": 119999999,
    "3170": 119999999,
    "2350": 119999999,
    "3660": 119999999,
    "80": 119999999,
    "3220": 119999999,
    "9510": 119999999,
    "2200": 119999999,
    "7300": 119999999,
    "9600": 119999999,
    "3520": 119999999,
    "2170": 119999999,
    "2160": 119999999,
    "3120": 119999999,
    "2150": 119999999,
    "3590": 119999999,
    "2290": 119999999,
    "5300": 119999999,
    "2240": 119999999,
    "3630": 119999999,
    "7500": 119999999,
    "3440": 119999999,
    "3560": 119999999,
    "9310": 119999999,
    "8200": 119999999,
    "2120": 119999999,
    "5200": 119999999,
    "3140": 119999999,
    "4410": 119999999,
    "4490": 119999999,
    "6219": 119999999,
    "3110": 119999999,
    "2000": 119999999,
    "2110": 119999999,
    "6221": 119999999,
    "2330": 119999999,
    "3650": 119999999,
    "3160": 119999999,
    "5000": 119999999,
    "3200": 119999999,
    "6211": 119999999,
    "7400": 119999999,
    "7800": 119999999,
    "2210": 119999999,
    "4360": 119999999,
    "2300": 119999999,
    "2220": 119999999,
    "6200": 119999999,
    "3150": 119999999,
    "6229": 119999999,
    "7600": 119999999,
    "2250": 119999999,
    "2320": 119999999,
    "9320": 119999999,
    "2400": 119999999,
    "3290": 119999999,
    "4320": 119999999,
    "4390": 119999999,
    "4000": 119999999,
    "6212": 119999999,
    "7200": 119999999,
    "7000": 119999999,
    "4300": 119999999,
    "6110": 119999999,
    "3500": 119999999,
    "3430": 119999999,
    "3620": 119999999,
    "7910": 119999999,
    "3420": 119999999,
    "3410": 119999999,
    "2100": 119999999,
    "3400": 119999999
}