{
    "11":110000000,
    "1000":110100000,
    "1100":110101000,
    "1110":110101000,
    "1120":110101000,
    "1200":110106000,
    "1300":110108000,
    "1400":110107000,
    "1500":110102000,
    "1510":110102000,
    "1520":110102000,
    "1600":110103000,
    "1610":110103000,
    "1620":110103000,
    "1700":110104000,
    "1800":110107000,
    "1900":110100000,
    "1910":110100000,
    "1920":110100000,
    "2000":110300000,
    "2100":110300000,
    "2110":110300000,
    "2120":110300000,
    "2130":110300000,
    "2140":110300000,
    "2150":110300000,
    "2160":110300000,
    "2170":110300000,
    "2190":110300000,
    "2200":110300000,
    "2210":110300000,
    "2220":110300000,
    "2230":110300000,
    "2240":110300000,
    "2250":110300000,
    "2260":110300000,
    "2290":110300000,
    "2300":110300000,
    "2310":110300000,
    "2320":110300000,
    "2330":110300000,
    "2340":110300000,
    "2350":110300000,
    "2390":110300000,
    "2400":110400000,
    "2900":110300000,
    "3400":120100000,
    "3450":110300000,
    "3900":120100000,
    "4000":110600000,
    "4100":110600002,
    "4200":110600999,
    "4300":110600000,
    "4320":110600999,
    "4330":110600999,
    "4350":110600003,
    "4351":110600003,
    "4352":110600003,
    "4360":110600999,
    "4370":110600999,
    "4380":110600001,
    "4390":110600000,
    "5000":110700000,
    "5100":110700000,
    "5200":110700000,
    "5300":110700000,
    "6211":110300000,
    "6212":110000000,
    "6219":110900000,
    "6221":110900000,
    "7000":110500000,
    "7100":110500000,
    "7200":110500000,
    "7300":110500000,
    "7400":110500000,
    "7500":110500000,
    "7600":110500000,
    "7700":110500000,
    "7800":110500000,
    "7910":110500000,
    "7920":129999999,
    "8100":110700000,
    "8200":111100000,
    "9100":111100000,
    "9110":111100000,
    "9211":110800000,
    "9213":110800000,
    "9310":110900000,
    "9510":111000000,
    "9520":129999999,
    "9600":110900000,
    "9910":110000000
}
